#######
# @####
# $ ###
## .  #
# $   #
#   . #
#######
