#######
##    #
###  .#
####  #
## ##$#
#  .$@#
#######
