#######
####. #
### $ #
###@. #
####$ #
####  #
#######
