#######
###.  #
###$  #
###   #
###.$##
####@##
#######
