#######
#..####
#$$####
#@ ####
#######
#######
#######
