#######
#######
###.  #
# $   #
#   $##
#  .@ #
#######
