#######
####@ #
### $ #
###  $#
### . #
###  .#
#######
