#######
#.@####
# $####
#   # #
#   $ #
#.    #
#######
