#######
###   #
## .. #
#   $ #
# $ @ #
##  ###
#######
