#######
###. ##
###  ##
## $ ##
##@$.##
##    #
#######
