#######
#     #
# $ $@#
###   #
###   #
###.. #
#######
