#######
#   .##
# $  ##
#@$.  #
##  ###
#######
#######
