#######
#####.#
####@ #
# # $ #
# $ . #
#     #
#######
