#######
####@ #
# $ $ #
#  .. #
####  #
####  #
#######
