#######
##### #
#### .#
##   .#
## $$ #
##  @ #
#######
