#######
#  .@##
# $$ ##
#    ##
# .####
#######
#######
