#######
###   #
##  $.#
##    #
###$. #
## @  #
#######
