#######
#  # ##
# $.  #
#     #
#   $ #
## .@##
#######
