#######
# $ . #
#@$ . #
# ##  #
####  #
##### #
#######
