#######
####  #
##. # #
#   . #
# $ $@#
#     #
#######
