#######
#  ####
#  $@##
# $ ###
#     #
# .. ##
#######
