#######
# @.###
#  $###
#   ###
#   $ #
#    .#
#######
