#######
#######
##### #
###@  #
###$$ #
#.  . #
#######
