#######
##   .#
## $  #
##   ##
## $ ##
##@.###
#######
