#######
###  .#
# #   #
# $  .#
#@$   #
###   #
#######
