#######
#   ###
# $ ###
#@$.###
# . ###
#   ###
#######
