#######
#######
####.##
#    .#
# $$  #
# @   #
#######
