#######
#    .#
#     #
#.$   #
# ##$ #
####@ #
#######
