#######
#######
#.#####
#  $@##
# .$ ##
#   ###
#######
