#######
#####.#
####  #
####$ #
####.$#
#### @#
#######
