#######
#######
## .###
##. $@#
### $ #
##    #
#######
