#######
# #   #
# $.  #
#@$  ##
###   #
#   . #
#######
