#######
#  . .#
# $$  #
#  @###
#######
#######
#######
