#######
#   ###
# . $ #
#     #
##. $ #
##  @ #
#######
