#######
#  ####
#. ####
# #####
#$## ##
#@$. ##
#######
