#######
##### #
#     #
# $ . #
## .$##
##  @##
#######
