#######
#######
####  #
##  . #
#@$   #
# $ . #
#######
