#######
####  #
#####.#
###.  #
### $$#
### @ #
#######
