#######
# .   #
# $   #
### $ #
###@.##
#### ##
#######
