#######
#@##  #
#$   ##
# $  ##
# #  ##
#..   #
#######
