#######
#### .#
####  #
####  #
###.$$#
#### @#
#######
