#######
#  . .#
# $$  #
##@#  #
#######
#######
#######
