#######
###.  #
###  ##
##    #
## $$ #
##. @ #
#######
