#######
#  .$ #
#@$ . #
#  ## #
# #   #
#     #
#######
