#######
# $.###
# .$@##
#   ###
# #####
#  ####
#######
