#######
#     #
# .$@ #
# $  ##
# # .##
#######
#######
