#######
#######
#######
#  .###
# $$. #
# @   #
#######
