#######
#     #
# $   #
#.  $@#
#  ####
##.####
#######
