#######
#     #
# $ # #
#@$ ###
#.#  ##
#   . #
#######
