#######
#     #
# .  .#
# $ $@#
#  ####
# #####
#######
