#######
#    ##
# .$ ##
# $####
#@.####
# #####
#######
