#######
#@$  .#
# .$ ##
# #####
#  ####
#  ####
#######
