#######
#  . ##
#   $@#
#.    #
##  $ #
#   ###
#######
