#######
#####.#
#### .#
#@$   #
#   $ #
#     #
#######
