#######
#######
####..#
#  #  #
#  #$$#
#    @#
#######
