#######
#.  ###
# . ###
# $$ ##
#  @ ##
#######
#######
