#######
#######
# @ ###
# $####
#   . #
# . $ #
#######
