#######
#  .  #
# $$ .#
# @####
# #####
#  ####
#######
