#######
####. #
# # . #
#@$   #
# $   #
#  ####
#######
