#######
##### #
#  .. #
# $   #
# ##$ #
#   @ #
#######
