#######
#     #
#@$  .#
####. #
####$ #
####  #
#######
