#######
#######
#######
# .$@ #
# . $ #
#     #
#######
