#######
##   ##
#@$. ##
# $ ###
#  ####
# .####
#######
