#######
#@    #
#$$  .#
# #   #
#.#####
#######
#######
