#######
##@####
# $####
#$  ###
#  .###
#. ####
#######
