#######
## .. #
##   ##
##@$  #
### $ #
###   #
#######
