#######
##@  ##
# $  ##
#  $###
##   .#
#.    #
#######
