#######
#     #
# $ # #
#@$ ###
# ..###
#   ###
#######
