#######
#######
#######
####  #
##. $ #
#.  $@#
#######
