#######
#.    #
### $ #
####.@#
####$ #
##    #
#######
