#######
###   #
###  .#
###@$.#
### $ #
###   #
#######
