#######
#######
#######
##### #
#@$  .#
# $ . #
#######
