#######
#  .. #
#     #
# $ ###
#  $###
#  @###
#######
