#######
#    ##
#  $@##
# $ ###
#.#.###
#######
#######
