#######
##  @##
##  $##
## . ##
## $ ##
##  .##
#######
