#######
### @##
####$ #
###  ##
# $ .##
#   . #
#######
