#######
####. #
####  #
#### .#
#  #$$#
#    @#
#######
