#######
#     #
#.  . #
# $   #
####$ #
####@ #
#######
