#######
#.. $@#
#   $ #
####  #
#######
#######
#######
