#######
##  @.#
##$ $ #
#   . #
#     #
##### #
#######
