#######
# . $ #
#@$ . #
###   #
#######
#######
#######
