#######
#### @#
####.$#
####$ #
####  #
#### .#
#######
