#######
#    ##
# $ ###
#@$.###
#  .###
#    ##
#######
