#######
# . .##
#     #
#@$   #
# ##$ #
####  #
#######
