#######
#######
#######
# .####
# $ $@#
#    .#
#######
