#######
#######
# @####
# $$ ##
#  .  #
#  .  #
#######
