#######
####  #
### $ #
###.$@#
### . #
##    #
#######
