#######
#######
## @###
#  $$ #
#   # #
#. .  #
#######
