#######
#   .@#
##  $ #
##    #
# $   #
#   . #
#######
