#######
#.  ###
# $.###
#  ####
#$#####
#@ ####
#######
