#######
#######
###@  #
###$  #
#   . #
# $ . #
#######
