#######
# .   #
#.  $ #
# $####
# @####
# #####
#######
