#######
#@    #
#$$#  #
#  ## #
#  ####
#. .###
#######
