#######
##### #
# .   #
##. $ #
### $@#
###   #
#######
