#######
#.  ###
##$ ###
#.  ###
# $@# #
#     #
#######
