#######
## .  #
#     #
#     #
#.$ $ #
# @####
#######
