#######
#  ####
#  # ##
#. #. #
#  $$ #
#  #@##
#######
