#######
#    ##
#.. ###
# $ ###
#$@####
#  ####
#######
