#######
####@ #
####$ #
###  .#
### $ #
#   . #
#######
