#######
#### @#
####$$#
####  #
####..#
####  #
#######
