#######
# . ###
# $@###
# $ ###
#.  ###
#  ####
#######
