#######
# #  ##
# $  ##
#.    #
#   $.#
#   @ #
#######
