#######
# .####
#  ####
# $   #
#@$.###
# #####
#######
