#######
#  @###
# $$ .#
##   .#
#######
#######
#######
