#######
##@####
##$####
#     #
#. $  #
#    .#
#######
