#######
#     #
# . $@#
#. ####
# $####
#  ####
#######
