#######
#######
###   #
### . #
# $$ .#
#  @ ##
#######
