#######
## .  #
## .  #
#    ##
# $$###
#  @ ##
#######
