#######
##### #
##### #
## $. #
## .$@#
##    #
#######
