#######
### @.#
### $ #
###. $#
###   #
#######
#######
