#######
###   #
###$. #
###   #
###.$ #
####@##
#######
