#######
# @####
# $ $ #
#     #
#    .#
#  .  #
#######
