#######
#@ ####
#$$####
#     #
#  .# #
#.   ##
#######
