#######
#    .#
#  #  #
#$  ###
#.$####
# @####
#######
