#######
#  ####
# $####
#   . #
#   $@#
#.    #
#######
