#######
#######
####  #
####$ #
###   #
#@$ ..#
#######
