#######
#.   ##
##.  ##
##  ###
# $$# #
#  @  #
#######
