#######
#######
#######
# #####
#  $. #
#.  $@#
#######
