#######
#     #
# #.$@#
#   $##
# .   #
#     #
#######
