#######
#######
#######
##   ##
#  .$ #
# . $@#
#######
