#######
# $ . #
#   $@#
# .   #
#######
#######
#######
