#######
#######
#######
# @##.#
# $$  #
#    .#
#######
