#######
# .  ##
# $ $@#
## . ##
###  ##
##   ##
#######
