#######
# . # #
# $$ .#
# @   #
#######
#######
#######
