#######
##@####
# $.###
#  .# #
# $   #
#     #
#######
