#######
####. #
# ##  #
# #   #
#@$   #
# $.  #
#######
