#######
#   @ #
## $$ #
#     #
# .  .#
####  #
#######
