#######
#   ###
# $####
# ..###
# $ ###
# @####
#######
