#######
#  .$@#
#   $ #
#  #  #
#.  # #
##    #
#######
