#######
# $ ..#
#     #
####$##
####@##
#######
#######
