#######
#  @###
#.$$###
##   ##
## .###
#   ###
#######
