#######
#. ####
#   ###
#$  $@#
#   ###
# . ###
#######
