#######
# #####
#    ##
# $ .##
#. $@##
##    #
#######
