#######
####@ #
####$$#
####  #
####. #
#####.#
#######
