#######
#  @###
#  $###
# . #.#
#   $ #
#     #
#######
