#######
###.  #
### $ #
#  #@ #
## #$ #
#   . #
#######
