#######
###   #
### ..#
####$$#
#### @#
#######
#######
