#######
###   #
### $ #
####. #
####$ #
####@.#
#######
