#######
##    #
#   $ #
#.@$. #
#  #  #
#######
#######
