#######
#######
#######
###@ ##
###$$.#
#  .  #
#######
