#######
#    ##
# $  ##
## . ##
##$  ##
# @.###
#######
