#######
####  #
###  .#
#@$   #
# $ .##
#######
#######
