#######
# @ ###
# $ ###
#  $ ##
#.  .##
#  ####
#######
