#######
# .  ##
#@$  ##
## . ##
## $###
##    #
#######
