#######
#  #  #
#. $  #
#   $ #
#  @. #
#######
#######
