#######
# @####
#.$$ ##
#    ##
#.   ##
#    ##
#######
