#######
####  #
#### .#
####. #
####$$#
####@ #
#######
