#######
# @   #
# $$ .#
#  ####
#  ####
#   .##
#######
