#######
# .@ ##
# $$###
##  ###
## .###
#######
#######
