#######
### @ #
### $##
#  $ ##
#.  . #
#     #
#######
