#######
#######
#####@#
#### $#
####$ #
####..#
#######
