#######
#### ##
#     #
#    .#
#. $$ #
###@###
#######
