#######
#  .$ #
#.  $@#
#######
#######
#######
#######
