#######
###  @#
### $$#
####. #
###   #
###  .#
#######
