#######
#  ####
#.$@###
#  ####
#$ ####
#. ####
#######
