#######
#  @ ##
#  $###
#.    #
#   $.#
##  ###
#######
