#######
# .  ##
#.  $@#
#    ##
#  $###
#   ###
#######
