#######
#     #
# $ .##
###.  #
####$ #
####@ #
#######
