#######
#.  $ #
#   $@#
#. ####
# #####
#  ####
#######
