#######
#   .##
#@$. ##
# $####
#  ####
# #####
#######
