#######
#######
### @ #
### $$#
####  #
####..#
#######
