#######
###   #
### $ #
###@$ #
#   . #
# #  .#
#######
