#######
#  ####
# $####
#    ##
#..$@##
###   #
#######
