#######
#.@####
# $####
#  ####
# $. ##
#   ###
#######
