#######
# ## @#
#.  $$#
#  # .#
####  #
#######
#######
