#######
#  @  #
# $.$.#
##    #
#######
#######
#######
