#######
####  #
### $ #
###.  #
### $ #
####@.#
#######
