#######
#@$  .#
# $ . #
#######
#######
#######
#######
