#######
##  ###
#  .$ #
# .   #
####$ #
####@ #
#######
