#######
#..   #
#     #
#     #
#  $$ #
#  @###
#######
