#######
#######
#######
#.   ##
#  $ ##
#  .$@#
#######
