#######
#    ##
# $@###
# $ ###
#.. ###
#   ###
#######
