#######
#  .###
# $####
#.$@###
# #####
#######
#######
