#######
###  .#
##@$  #
### $ #
####. #
#######
#######
