#######
#..####
# $####
#  ####
#$#####
#@ ####
#######
