#######
###.  #
####  #
####$.#
#### $#
#####@#
#######
