#######
#    .#
# . $ #
####  #
#####$#
#### @#
#######
