#######
##@.  #
##$   #
#     #
# $ # #
#   . #
#######
