#######
#     #
#..$ ##
#   ###
# $####
##@####
#######
