#######
#######
#######
#     #
#   $@#
# .$ .#
#######
