#######
#    ##
#.  ###
#.   ##
#  $$ #
#  @  #
#######
