#######
#     #
# $.. #
### $ #
####@ #
#######
#######
