#######
#   ###
#  ## #
#   $@#
#. $. #
#  ####
#######
