#######
#   @.#
##  $ #
###$  #
##    #
##.   #
#######
