#######
#.  $ #
#.  $@#
#   ###
#######
#######
#######
