#######
#######
###.@##
###$  #
##  $ #
##.   #
#######
