#######
##    #
## $ .#
### . #
###$ ##
###@  #
#######
