#######
####  #
####. #
# .#  #
#  $$ #
#   @ #
#######
