#######
##### #
###.  #
##  $@#
##. $ #
####  #
#######
