#######
#   .##
# $  ##
#.  $@#
#### ##
#######
#######
