#######
#  ####
# $ $@#
#   .##
# .  ##
# #####
#######
