#######
#.#####
# #####
#$#####
#   ###
#.$@###
#######
