#######
#   ###
# . ###
##  .##
# $$###
#  @###
#######
