#######
#     #
#  .$ #
#   $@#
##.## #
#######
#######
