#######
##   ##
##   .#
##@$ ##
## $ .#
#     #
#######
