#######
# .  @#
#   $ #
####  #
#######
#######
#######
