#######
####  #
##  # #
#   . #
# $  @#
#     #
#######
