#######
#### @#
####. #
####$ #
####  #
####  #
#######
