#######
#  # ##
# $   #
#     #
#     #
## .@##
#######
