#######
#######
#######
#   @ #
# . $ #
#     #
#######
