#######
##  @##
##  $##
##   ##
##   ##
##  .##
#######
