#######
#   .##
#     #
#@$   #
# ##  #
####  #
#######
