#######
#@    #
# $#  #
#  ## #
#  ####
#  .###
#######
