#######
###   #
## .  #
#   $ #
#   @ #
##  ###
#######
