#######
##### #
#   . #
# $   #
# ##  #
#   @ #
#######
