#######
# @.###
#   ###
#   ###
#   $ #
#     #
#######
