#######
#     #
#     #
#.  $@#
#  ####
## ####
#######
