#######
#  . ##
#    @#
#     #
##  $ #
#   ###
#######
