#######
#.    #
### $ #
#### @#
####  #
##    #
#######
