#######
##    #
###  .#
####  #
## ##$#
#    @#
#######
