#######
#######
##  ###
##. $@#
###   #
##    #
#######
