#######
#     #
#   $@#
###   #
###   #
###.  #
#######
