#######
#   ###
# $.###
#  ####
# #####
#@ ####
#######
