#######
#   . #
#     #
#   ###
#  $###
#  @###
#######
