#######
#####.#
####  #
####  #
#### $#
#### @#
#######
