#######
# @####
# $ ###
##    #
#     #
#   . #
#######
