#######
####  #
##### #
###.  #
### $ #
### @ #
#######
