#######
#  # ##
#  .  #
#     #
#   $ #
##  @##
#######
