#######
#    ##
# $  ##
#@ .  #
##  ###
#######
#######
