#######
####  #
### $ #
###  @#
### . #
##    #
#######
