#######
#  .  #
# $   #
#  @###
#######
#######
#######
