#######
##    #
## $  #
##   ##
##   ##
##@.###
#######
