#######
#### @#
#### $#
####  #
####  #
#### .#
#######
