#######
#    .#
#     #
# $   #
# ##  #
####@ #
#######
