#######
#     #
#     #
#.    #
# ##$ #
####@ #
#######
