#######
#     #
# .   #
#   $@#
#  ####
# #####
#######
