#######
#######
###.  #
#     #
#   $##
#   @ #
#######
