#######
##    #
###   #
####  #
## ## #
#  .$@#
#######
