#######
#     #
#   # #
#@$ ###
#  .###
#   ###
#######
