#######
#   ###
##  ###
#.  ###
# $@# #
#     #
#######
