#######
###. ##
###  ##
## $ ##
##@  ##
##    #
#######
