#######
#     #
#  $@ #
#    ##
# # .##
#######
#######
