#######
#######
## .###
##   @#
### $ #
##    #
#######
