#######
##@####
#  ####
#$  ###
#   ###
#. ####
#######
