#######
#######
# @####
#  $ ##
#     #
#  .  #
#######
