#######
####  #
####  #
#### .#
#  # $#
#    @#
#######
