#######
#     #
# . @ #
# $  ##
# #  ##
#######
#######
