#######
#  ####
#   @##
# $ ###
#     #
#  . ##
#######
