#######
# .####
# $####
#@ ####
#######
#######
#######
