#######
#######
##### #
###@  #
###$  #
#.    #
#######
