#######
#@    #
#$ #  #
#  ## #
#  ####
#.  ###
#######
