#######
####@ #
### $ #
###   #
### . #
###   #
#######
