#######
##### #
#     #
##.   #
### $@#
###   #
#######
