#######
#.@####
#  ####
#   # #
#   $ #
#     #
#######
