#######
####  #
#### .#
####  #
#### $#
#### @#
#######
