#######
#     #
#@$   #
####. #
####  #
####  #
#######
