#######
##### #
# .   #
##  $ #
###  @#
###   #
#######
