#######
###  ##
###  ##
##   ##
##@$.##
##    #
#######
