#######
#######
#.#####
#  $@##
#    ##
#   ###
#######
