#######
#####.#
####@ #
# # $ #
#     #
#     #
#######
