#######
###   #
# #   #
#    .#
#@$   #
###   #
#######
