#######
###.  #
###  ##
##    #
##  $ #
##  @ #
#######
