#######
##  . #
##   ##
##@$  #
###   #
###   #
#######
