#######
#     #
# $ # #
#@  ###
#.#  ##
#     #
#######
