#######
#### .#
####  #
####  #
###  $#
#### @#
#######
