#######
#######
## @###
#  $  #
#   # #
#  .  #
#######
