#######
#   ###
#   ###
#@$.###
#   ###
#   ###
#######
