#######
# . $ #
#@    #
###   #
#######
#######
#######
