#######
#######
#######
#  ####
# $  @#
#    .#
#######
