#######
#    ##
# .$ ##
#  ####
#@ ####
# #####
#######
