#######
####. #
# #   #
#@$   #
#     #
#  ####
#######
