#######
####@ #
#   $ #
#  .  #
####  #
####  #
#######
