#######
#   .##
#    ##
#@$   #
##  ###
#######
#######
