#######
#    ##
#   @##
# $ ###
# #.###
#######
#######
