#######
####@ #
# $   #
#   . #
####  #
####  #
#######
