#######
# $ . #
#@    #
# ##  #
####  #
##### #
#######
