#######
#    ##
#   ###
#@$.###
#   ###
#    ##
#######
