#######
#######
#######
####  #
##. $ #
#    @#
#######
