#######
##   ##
#@$. ##
#   ###
#  ####
#  ####
#######
