#######
#######
#######
##### #
#@    #
# $ . #
#######
