#######
##@  ##
# $  ##
#   ###
##   .#
#     #
#######
