#######
#@##  #
#$   ##
#    ##
# #  ##
#.    #
#######
