#######
#@    #
#$    #
# #   #
#.#####
#######
#######
