#######
# .  ##
#     #
#@    #
# ##$ #
####  #
#######
