#######
#######
####  #
##  . #
#@$   #
#     #
#######
