#######
#######
#######
#   ###
#  $. #
# @   #
#######
