#######
#   ###
# . ###
#  $ ##
#  @ ##
#######
#######
