#######
#. ####
#$ ####
#@ ####
#######
#######
#######
