#######
### @##
####$ #
###  ##
#    ##
#   . #
#######
