#######
####  #
###   #
###.$@#
###   #
##    #
#######
