#######
#     #
#@$ . #
#  ## #
# #   #
#     #
#######
