#######
##### #
#### .#
##    #
##  $ #
##  @ #
#######
