#######
###   #
##   .#
##    #
###$  #
## @  #
#######
