#######
#.  ###
#   ###
# $  ##
#  @ ##
#######
#######
