#######
##### #
####  #
##   .#
## $  #
##  @ #
#######
