#######
###.  #
###   #
###   #
### $##
####@##
#######
