#######
# .   #
#     #
# $####
# @####
# #####
#######
