#######
###   #
##  . #
#     #
# $ @ #
##  ###
#######
