#######
####. #
####  #
####  #
#  #$ #
#    @#
#######
