#######
# #   #
# $.  #
#@   ##
###   #
#     #
#######
