#######
##  @##
##   ##
## . ##
## $ ##
##   ##
#######
