#######
#######
#######
#######
#     #
#@$  .#
#######
