#######
#  .@##
# $  ##
#    ##
#  ####
#######
#######
