#######
#######
# #####
#   @##
# .$ ##
#   ###
#######
