#######
#.  ###
#   ###
#  ####
#$#####
#@ ####
#######
