#######
####  #
# # . #
#@    #
# $   #
#  ####
#######
