#######
####  #
#####.#
###   #
###  $#
### @ #
#######
