#######
#######
# @ ###
#  ####
#     #
# . $ #
#######
