#######
#######
#######
##### #
#@$  .#
#     #
#######
