#######
#######
#### ##
#    .#
# $   #
# @   #
#######
