#######
####  #
###   #
###@. #
####$ #
####  #
#######
