#######
###   #
###$  #
###   #
###. ##
####@##
#######
