#######
#     #
###   #
####.@#
####$ #
##    #
#######
