#######
#  .  #
# $   #
# @####
# #####
#  ####
#######
