#######
#######
#######
# .$@ #
#     #
#     #
#######
