#######
#  .$ #
#@    #
#  ## #
# #   #
#     #
#######
