#######
#     #
#@$ . #
# ##  #
####  #
##### #
#######
