#######
#####.#
####  #
#@$   #
#     #
#     #
#######
