#######
##### #
####  #
####$ #
####. #
#### @#
#######
