#######
###   #
##  $ #
##    #
### . #
## @  #
#######
