#######
#    ##
# $ ###
#@  ###
#  .###
#    ##
#######
