#######
##### #
####@ #
# #   #
# $ . #
#     #
#######
