#######
#     #
# $   #
###   #
###@.##
#### ##
#######
