#######
#@$  .#
#    ##
# #####
#  ####
#  ####
#######
