#######
###   #
###   #
### @##
### $ #
###  .#
#######
