#######
#     #
# $   #
#    @#
#  ####
##.####
#######
