#######
#     #
#   . #
# $   #
####  #
####@ #
#######
