#######
##### #
#### .#
#@    #
#   $ #
#     #
#######
