#######
#######
####. #
#  #  #
#  #$ #
#    @#
#######
