#######
#  .  #
#     #
# $ ###
#   ###
#  @###
#######
