#######
#  ####
#. ####
# #####
#$## ##
#@   ##
#######
