#######
##    #
#     #
#     #
#.  $ #
# @####
#######
