#######
#  ####
#  ####
# #####
# ## ##
#@$. ##
#######
