#######
#######
#######
#  .###
# $   #
# @   #
#######
