#######
#######
# @ ###
# $####
#   . #
#     #
#######
