#######
# $.###
#   @##
#   ###
# #####
#  ####
#######
