#######
#    @#
##  $ #
##    #
#     #
#   . #
#######
