#######
##### #
#  .  #
#     #
# ##$ #
#   @ #
#######
