#######
## .  #
##   ##
##@   #
### $ #
###   #
#######
