#######
# @ ###
#  $###
#   ###
#     #
#    .#
#######
