#######
#   .@#
##    #
##    #
# $   #
#     #
#######
