#######
##  @.#
##  $ #
#     #
#     #
##### #
#######
