#######
#@    #
# $  .#
# #   #
# #####
#######
#######
