#######
##  @ #
##$   #
#   . #
#     #
##### #
#######
