#######
#######
#### .#
#  #  #
#  # $#
#    @#
#######
