#######
###   #
###  .#
###@  #
### $ #
###   #
#######
