#######
####  #
##. # #
#     #
#   $@#
#     #
#######
