#######
#    .#
#  $  #
#  @###
#######
#######
#######
