#######
#######
###@  #
###   #
#     #
# $ . #
#######
