#######
#     #
#    .#
# $  @#
#  ####
# #####
#######
