#######
#######
# @####
# $  ##
#  .  #
#     #
#######
