#######
##### #
#     #
# $   #
## . ##
##  @##
#######
