#######
#.  $@#
#     #
####  #
#######
#######
#######
