#######
##### #
#     #
#   . #
##  $##
##  @##
#######
