#######
#######
#######
#######
# $ . #
#@    #
#######
