#######
#######
## @###
#   $ #
#   # #
#.    #
#######
