#######
#     #
#@   .#
####  #
####$ #
####  #
#######
