#######
#     #
#.    #
#     #
####$ #
####@ #
#######
