#######
####@ #
###   #
###  $#
###   #
###  .#
#######
