#######
#######
###@  #
###$  #
#   . #
#     #
#######
