#######
#   ###
#   $ #
#     #
##.   #
##  @ #
#######
