#######
#     #
# $ # #
#@  ###
# . ###
#   ###
#######
