#######
#     #
#  $ .#
# @####
# #####
#  ####
#######
