#######
####. #
### $ #
###@  #
####  #
####  #
#######
