#######
#######
#######
# .####
#   $@#
#     #
#######
