#######
####. #
####  #
####  #
####$ #
#### @#
#######
