#######
##   .#
##    #
##   ##
## $ ##
##@ ###
#######
