#######
#     #
#@$ . #
###   #
#######
#######
#######
