#######
#@##  #
#    ##
# $  ##
# #  ##
# .   #
#######
