#######
#   ###
# .$@##
#   ###
# #####
#  ####
#######
