#######
#    ##
#    ##
# $####
#@.####
# #####
#######
