#######
#     #
#.  $ #
#  ####
# @####
# #####
#######
