#######
###   #
###   #
###@$.#
###   #
###   #
#######
