#######
## .  #
#     #
#     #
# $   #
# @####
#######
