#######
###  .#
### $ #
### @##
###   #
###   #
#######
