#######
# @####
#   ###
## .  #
# $   #
#     #
#######
