#######
###  .#
# #   #
# $   #
#@    #
###   #
#######
