#######
#   @##
#  $ ##
#    ##
# .####
#######
#######
