#######
#######
#######
#######
# ### #
#  @$.#
#######
