#######
#   ###
# $ ###
#@  ###
# . ###
#   ###
#######
