#######
#.  ###
##$ ###
#   ###
#  @# #
#     #
#######
