#######
# @####
# $####
#   # #
#     #
#.    #
#######
