#######
###   #
###  ##
##    #
## $  #
##. @ #
#######
