#######
#@    #
# .$ ##
# #####
#  ####
#  ####
#######
