#######
#     #
# $  @#
###   #
###   #
### . #
#######
