#######
#    ##
#  $@##
#   ###
#.# ###
#######
#######
