#######
##@  ##
#    ##
#  $###
##    #
#.    #
#######
