#######
#   ###
# .   #
#     #
##  $ #
##  @ #
#######
