#######
#######
#######
####  #
##    #
#.  $@#
#######
