#######
#    ##
#   $@#
#.    #
##    #
#   ###
#######
