#######
#######
####  #
##    #
#@    #
# $ . #
#######
