#######
# #   #
#     #
#@$  ##
###   #
#   . #
#######
