#######
#    .#
#  $  #
##@#  #
#######
#######
#######
