#######
# .   #
#     #
### $ #
###@ ##
#### ##
#######
