#######
#######
#######
#######
# ### #
#.$@  #
#######
