#######
#  .  #
# $   #
##@#  #
#######
#######
#######
