#######
##   ##
#@   ##
# $ ###
#  ####
# .####
#######
