#######
#######
####.##
#     #
#  $  #
# @   #
#######
