#######
#     #
#   # #
#@$ ###
# #  ##
#   . #
#######
