#######
##@####
# $####
#   ###
#  .###
#  ####
#######
