#######
####  #
####  #
####  #
###.$ #
#### @#
#######
