#######
### @##
####  #
###  ##
# $ .##
#     #
#######
