#######
#######
###   #
# $   #
#    ##
#  .@ #
#######
