#######
#######
##### #
###@  #
### $ #
#   . #
#######
