#######
#  ####
#  $@##
#   ###
#     #
# .  ##
#######
