#######
#######
#######
### .##
## $$.#
#@$  .#
#######
