#######
#. $ .#
# $.  #
#  ####
#$#####
#@ ####
#######
