#######
#  .$@#
#.$.$ #
#     #
#######
#######
#######
