#######
#@  ###
#$$ ###
# $ ###
#..####
#. ####
#######
