#######
# @####
#.$####
#$ ####
#  $ .#
#.   ##
#######
