#######
##.  ##
## $$ #
##@.$.#
####  #
###   #
#######
