#######
##@####
##$  .#
# . $ #
#  #$ #
#.    #
#######
