#######
#######
#######
###.#.#
#. $$$#
#  @  #
#######
