#######
###.$.#
####$@#
#### $#
####  #
####. #
#######
