#######
## $. #
#@$.  #
# $.  #
#######
#######
#######
