#######
####.@#
####$$#
###   #
### $.#
### . #
#######
