#######
#####.#
##@$. #
# . $$#
# #   #
#  ####
#######
