#######
####@##
##  $ #
## . $#
####  #
#. $ .#
#######
