#######
#@. $ #
# $$  #
# ..###
#  ####
#######
#######
