#######
#@$ ..#
# $  .#
####$ #
####  #
##### #
#######
