#######
###@###
# .$  #
##.  $#
### $ #
###  .#
#######
