#######
##    #
## $  #
###$..#
#@$  ##
#  . ##
#######
