#######
##@$ .#
####$ #
#### $#
####  #
####..#
#######
