#######
#######
# ### #
#@$  .#
#. $$ #
#  .  #
#######
