#######
#   # #
#@$ ..#
#.$ $ #
#  #  #
#######
#######
