#######
###  .#
## .$ #
##@$  #
###$. #
###   #
#######
