#######
#  # ##
# $ $@#
#.  .##
#  $  #
#  . ##
#######
