#######
#   ###
#  $.##
#  . ##
#.$$###
# @ ###
#######
