#######
#### ##
##  . #
## . $#
###$$ #
## @ .#
#######
