#######
#######
# #####
# #####
#@$ . #
# $.$.#
#######
