#######
##  @ #
##$ $ #
# $  .#
# . .##
#    ##
#######
