#######
## .$ #
####. #
####  #
### $ #
## .$@#
#######
