#######
#. ####
# #####
#  ####
#$$ ###
#@$. .#
#######
