#######
# $.  #
#@$   #
####. #
####$.#
####  #
#######
