#######
#   @##
#  .$##
# # .##
# $ $ #
#   . #
#######
