#######
# @  .#
# $.$ #
#  $###
#  .###
## ####
#######
