#######
# #####
#. .  #
#@$   #
####$ #
###.$ #
#######
