#######
##@.$.#
## $$.#
##   ##
#######
#######
#######
