#######
####@ #
####$ #
# .   #
##$ $ #
## .. #
#######
