#######
#   ###
#  $$ #
#.  . #
#@$.  #
# ##  #
#######
