#######
#######
#.#####
#$##. #
#. $$ #
#   @ #
#######
