#######
#######
###..@#
## $$ #
### $ #
##.   #
#######
