#######
## #. #
# $   #
#  .  #
# $ $ #
####@.#
#######
