#######
#.  ###
# $.###
# $  ##
#$  ###
#@.   #
#######
