#######
#   . #
# $  .#
# $$###
#  @.##
# #####
#######
