#######
### ###
###.  #
#  $. #
# $$. #
##@  ##
#######
