#######
#. ####
#   $@#
#   $.#
# .#$ #
#  #  #
#######
