#######
#. @ ##
# $$###
#   $ #
#   ..#
#######
#######
