#######
###@###
#. $ .#
# $   #
# $. ##
#  ####
#######
