#######
#.  . #
# $ .##
# $$ ##
#  @ ##
#######
#######
