#######
#######
##  ###
#. .$@#
#  $  #
#.  $ #
#######
