#######
#######
# .$ ##
#   .##
#.$ $ #
# @   #
#######
