#######
# .   #
# $ ..#
##   ##
##$ $@#
##    #
#######
