#######
#@. ###
#$  ###
#.$.###
# $ ###
#    ##
#######
