#######
#######
#  . ##
#  . ##
# $ $ #
# $ @.#
#######
