#######
##  # #
## $$ #
##.  .#
#  .$ #
##  @ #
#######
