#######
# @.###
##$$###
# $   #
# .  .#
#     #
#######
