#######
#  # ##
# .@  #
# $$$ #
# # . #
##.  ##
#######
