#######
### $.#
### .##
###  ##
####$ #
##. $@#
#######
