#######
#######
#######
#### @#
#  .$$#
#. $ .#
#######
