#######
###  ##
# .$  #
##  $ #
#  .$@#
#   . #
#######
