#######
##    #
##..$ #
##$.$ #
##@   #
#######
#######
