#######
# . $@#
# . $$#
####  #
#####.#
#######
#######
