#######
# . $ #
#  $.@#
#  #$ #
# .#  #
#   ###
#######
