#######
#### @#
####.$#
### $ #
### $ #
###. .#
#######
