#######
#######
###@$.#
##.$  #
##  $ #
##  . #
#######
