#######
##### #
#     #
# ..$ #
#.$#$ #
##@   #
#######
