#######
#  @  #
## $$ #
##..$ #
### . #
###   #
#######
