#######
##  ..#
##@$. #
### $ #
### $ #
####  #
#######
