#######
#######
# .. ##
# $ ###
#@$.$ #
##    #
#######
