#######
#.  $.#
#  $$.#
#    @#
#######
#######
#######
