#######
#.#####
# # ###
#.$@###
# $ ###
#.$ ###
#######
