#######
# ## .#
#  #  #
# $$ $#
# . .@#
#######
#######
