#######
#   ###
# . .##
# $.###
# $$###
#  @###
#######
