#######
#######
### . #
#@$ $ #
## $..#
#     #
#######
