#######
##  . #
##.$  #
##  . #
##$$ ##
##@ ###
#######
