#######
##  .@#
### $$#
####  #
####$ #
####..#
#######
