#######
#    ##
# .$. #
#.  ###
#$$####
#@  ###
#######
