#######
#  .  #
# $ $@#
#.    #
### $ #
###  .#
#######
