#######
# . $@#
# .$$ #
#     #
# #####
#.#####
#######
