#######
#.    #
#$  . #
# $ ###
#. $###
#  @###
#######
