#######
####. #
####  #
### $.#
## $  #
#@$.  #
#######
