#######
##  @ #
## $$$#
### . #
####..#
#######
#######
