#######
# $  .#
#@$   #
####  #
##.$. #
#     #
#######
