#######
# .  .#
#. $  #
####$ #
#### $#
#####@#
#######
