#######
###  @#
###$$$#
###. .#
####. #
####  #
#######
