#######
#####.#
## @  #
## $$ #
###.$.#
###   #
#######
