#######
###   #
####$ #
##  $@#
# ..  #
# $ . #
#######
