#######
#   . #
# .$ ##
#  $ ##
# $####
#@.####
#######
