#######
#######
#######
### ..#
####$$#
## .$@#
#######
