#######
####. #
##@$  #
###$  #
## .# #
##. $ #
#######
