#######
###@  #
##.$  #
##  $ #
## $. #
##.  ##
#######
