#######
##    #
##  . #
##.$ ##
## $$ #
## @. #
#######
