#######
#     #
# $$  #
#.   .#
##  $##
###@.##
#######
