#######
##@## #
# $   #
#  $$ #
#. . ##
# . ###
#######
