#######
#######
# #####
# ... #
# $$$##
# @   #
#######
