#######
#@    #
#$$  ##
#.#$ ##
#    .#
#. # ##
#######
