#######
### @.#
####$ #
###  $#
### . #
### $.#
#######
