#######
#  ####
#    ##
#.#  .#
# $$ ##
# .$@##
#######
