#######
## $. #
##@$. #
##   .#
###$ ##
###  ##
#######
