#######
##@####
# $  ##
#. $###
#$. ###
#  .###
#######
