#######
#  .$ #
#.  $@#
#$#####
# #####
#.#####
#######
