#######
# #####
# #. .#
# .$  #
# $ $ #
# @   #
#######
