#######
#@$  .#
# $.$.#
## ####
##  ###
## ####
#######
