#######
#######
##    #
## $$@#
## .$.#
## . ##
#######
