#######
##    #
## .  #
#    ##
#  $###
#  @ ##
#######
