#######
#######
#######
###@ ##
###$  #
#  .  #
#######
