#######
####  #
###   #
#@    #
# $ .##
#######
#######
