#######
# .####
#  ####
# $   #
#@  ###
# #####
#######
