#######
#.  $ #
#    @#
#   ###
#######
#######
#######
