#######
#  ####
# $####
#   . #
#    @#
#     #
#######
