#######
###  .#
##@   #
### $ #
####  #
#######
#######
