#######
####@ #
####$ #
###   #
###   #
#   . #
#######
