#######
#   # #
#  $ .#
# @   #
#######
#######
#######
