#######
#.   ##
##   ##
##  ###
#  $# #
#  @  #
#######
