#######
### @ #
###  ##
#  $ ##
#   . #
#     #
#######
