#######
#  @ ##
#  $###
##  ###
## .###
#######
#######
