#######
#  ####
#  ####
#     #
#@$.###
# #####
#######
