#######
# @ ###
# $ ###
#    ##
#   .##
#  ####
#######
