#######
#   .##
# $  ##
#    @#
#### ##
#######
#######
