#######
#  ####
#  @###
#  ####
#$ ####
#. ####
#######
