#######
# $ . #
#    @#
#     #
#######
#######
#######
