#######
# #####
#    ##
# $ .##
#   @##
##    #
#######
