#######
#     #
#     #
#   $@#
##.## #
#######
#######
