#######
###  @#
### $ #
####. #
###   #
###   #
#######
