#######
# @####
#   $ #
#     #
#     #
#  .  #
#######
