#######
#  #  #
#.    #
#   $ #
#  @  #
#######
#######
