#######
###.  #
####  #
####$ #
####  #
#####@#
#######
