#######
####  #
# ##  #
# #   #
#@    #
# $.  #
#######
