#######
# #####
#    ##
#    ##
#. $@##
##    #
#######
