#######
#   ###
#  ## #
#    @#
#  $. #
#  ####
#######
