#######
#   ###
#   ###
##  .##
#  $###
#  @###
#######
