#######
#     #
# . $@#
#  ####
#  ####
#  ####
#######
