#######
#   @ #
##  $ #
###   #
##    #
##.   #
#######
