#######
#### @#
####$ #
####  #
####. #
####  #
#######
