#######
#   .##
#@   ##
# $####
#  ####
# #####
#######
