#######
#     #
#  .$ #
#    @#
## ## #
#######
#######
