#######
#  ####
#  # ##
#. #  #
#  $  #
#  #@##
#######
