#######
# $ . #
#     #
#### ##
####@##
#######
#######
