#######
###  @#
###  $#
####  #
###   #
###  .#
#######
