#######
#    ##
#  @###
# $ ###
# . ###
#   ###
#######
