#######
#  ####
#.$@###
#  ####
#  ####
#  ####
#######
