#######
###   #
### $ #
###@  #
#   . #
# #   #
#######
