#######
###   #
### . #
####$ #
#### @#
#######
#######
