#######
##  ###
#   $ #
# .   #
####  #
####@ #
#######
