#######
#    ##
##.  ##
##  ###
# $ # #
#  @  #
#######
