#######
# @####
# $####
#  ####
#  . ##
#   ###
#######
