#######
# .  ##
#    @#
#    ##
#  $###
#   ###
#######
