#######
### @ #
### $##
#    ##
#.    #
#     #
#######
