#######
#@ ####
#$ ####
#     #
#   # #
#.   ##
#######
