#######
#######
#######
##   ##
#     #
# . $@#
#######
