#######
#######
#####@#
#### $#
####  #
#### .#
#######
