#######
#.@####
#  ####
#  ####
# $  ##
#   ###
#######
