#######
#     #
#   $@#
#. ####
# #####
#  ####
#######
