#######
#  ####
# $####
#    ##
# . @##
###   #
#######
