#######
##@####
#  .###
#   # #
# $   #
#     #
#######
