#######
#######
####  #
####  #
###   #
#@$  .#
#######
