#######
#  ####
#  ####
#     #
#   $@#
#.    #
#######
