#######
# #####
# #####
# #####
#   ###
#.$@###
#######
