#######
####  #
### $ #
###   #
###   #
####@.#
#######
