#######
# .  ##
# $  @#
##   ##
###  ##
##   ##
#######
