#######
#   ###
#  ## #
#   $@#
#.    #
#  ####
#######
