#######
#     #
#  #  #
#$  ###
#. ####
# @####
#######
