#######
####. #
# ##  #
# #   #
#@$   #
#     #
#######
