#######
#######
#######
# #####
#  $. #
#    @#
#######
