#######
#@ ####
# $####
#     #
#  .# #
#    ##
#######
