#######
#  ####
# $  @#
#   .##
#    ##
# #####
#######
