#######
#######
#######
# @## #
# $   #
#    .#
#######
