#######
#######
#######
#    ##
#    ##
#  .$@#
#######
