#######
# @   #
#  $ .#
#  ####
#  ####
#    ##
#######
