#######
#     #
#.   ##
#   ###
# $####
##@####
#######
