#######
# @####
# $   #
#     #
#    .#
#     #
#######
