#######
####  #
###  .#
#@$   #
#    ##
#######
#######
