#######
#    ##
#   ###
#.   ##
#   $ #
#  @  #
#######
