#######
#    ##
# $@###
#   ###
#.  ###
#   ###
#######
