#######
#     #
# # $@#
#    ##
# .   #
#     #
#######
