#######
# @####
#. $ ##
#    ##
#    ##
#    ##
#######
