#######
# @####
# $  ##
#    ##
#.   ##
#    ##
#######
