#######
####@ #
#### $#
####  #
####  #
#####.#
#######
