#######
#     #
# . $ #
####  #
##### #
#### @#
#######
