#######
#  .$ #
#    @#
#######
#######
#######
#######
