#######
####. #
####$ #
####@ #
####  #
####  #
#######
