#######
#   ###
# $####
# . ###
#   ###
# @####
#######
