#######
###   #
###$  #
###   #
###.  #
####@##
#######
