#######
###   #
###  .#
#### $#
#### @#
#######
#######
