#######
#   ###
# . ###
##   ##
# $ ###
#  @###
#######
