#######
##    #
## $  #
### . #
###  ##
###@  #
#######
