#######
####  #
####. #
#  #  #
#   $ #
#   @ #
#######
