#######
# @ ###
#   ###
#  $ ##
#.   ##
#  ####
#######
