#######
#   ###
#  ####
#.$@###
# #####
#######
#######
