#######
#######
#####@#
####  #
####$ #
####. #
#######
