#######
#@    #
# $ . #
#######
#######
#######
#######
