#######
#### ##
#     #
#     #
#.  $ #
###@###
#######
