#######
#. ####
#  ####
#  ####
#$#####
#@ ####
#######
