#######
#######
####  #
####$ #
###   #
#@  . #
#######
