#######
#  @###
#  $###
#   #.#
#     #
#     #
#######
