#######
# .  ##
#@   ##
##   ##
## $###
##    #
#######
