#######
##@####
##$####
#     #
#     #
#    .#
#######
