#######
#    .#
#  #  #
#   ###
# $####
# @####
#######
