#######
##  ###
#  .  #
#     #
####$ #
####@ #
#######
