#######
###   #
###   #
####. #
####$ #
####@ #
#######
