#######
#  @###
#   ###
# . # #
#   $ #
#     #
#######
