#######
#   @ #
## $  #
#     #
#    .#
####  #
#######
