#######
#     #
#   .##
###   #
####$ #
####@ #
#######
