#######
#     #
# $  ##
###.  #
####  #
####@ #
#######
