#######
#######
#######
# #####
#     #
#.  $@#
#######
