#######
####  #
####  #
####@ #
####$ #
####. #
#######
