#######
#    ##
#.  $@#
#    ##
#   ###
#   ###
#######
