#######
####@ #
####  #
###  .#
### $ #
#     #
#######
