#######
#    .#
#     #
####$##
####@##
#######
#######
