#######
##### #
###   #
##  $@#
##.   #
####  #
#######
