#######
#######
#######
###@ ##
### $.#
#     #
#######
