#######
#  @###
#.$ ###
##   ##
##  ###
#   ###
#######
