#######
#.    #
#     #
#     #
#  $  #
#  @###
#######
