#######
#######
#######
##   ##
#  .$ #
#    @#
#######
