#######
# .####
# $####
#  ####
# #####
#@ ####
#######
