#######
#     #
# #. @#
#   $##
#     #
#     #
#######
