#######
# #  ##
# $  ##
#     #
#    .#
#   @ #
#######
