#######
##@####
# $ ###
#  .# #
#     #
#     #
#######
