#######
####  #
#### .#
####  #
#### $#
####@ #
#######
