#######
#     #
#.  $@#
#######
#######
#######
#######
