#######
#  ####
#   ###
#   $@#
#   ###
# . ###
#######
