#######
#    ##
#   $@#
## . ##
###  ##
##   ##
#######
