#######
#  ####
#  # ##
#  #. #
#   $ #
#  #@##
#######
