#######
#    ##
#.  ###
#    ##
#  $  #
#  @  #
#######
