#######
##### #
##### #
##    #
## .$@#
##    #
#######
