#######
#@$  .#
#     #
#######
#######
#######
#######
