#######
#######
###   #
### . #
#  $  #
#  @ ##
#######
