#######
# . ###
#  @###
# $ ###
#   ###
#  ####
#######
