#######
##@   #
##$   #
#     #
#   # #
#   . #
#######
