#######
#######
### @ #
### $ #
####  #
####. #
#######
