#######
#######
###   #
###   #
# $  .#
#  @ ##
#######
