#######
#  @###
#  $  #
##   .#
#######
#######
#######
