#######
## .  #
##    #
#    ##
# $ ###
#  @ ##
#######
