#######
#  @  #
# $.  #
##    #
#######
#######
#######
