#######
#     #
# .$ ##
#   ###
#  ####
##@####
#######
