#######
#     #
#.  $@#
#   ###
#######
#######
#######
