#######
#    ##
#.  ###
#   ###
#$@####
#  ####
#######
