#######
#. ####
#   ###
#$   @#
#   ###
#   ###
#######
