#######
#  ####
#   $@#
#    ##
# .  ##
# #####
#######
