#######
##### #
###.  #
##   @#
##  $ #
####  #
#######
