#######
#     #
#    @#
#. ####
# $####
#  ####
#######
