#######
#### ##
#     #
#    .#
#  $  #
###@###
#######
