#######
#.  $ #
#    @#
#  ####
# #####
#  ####
#######
