#######
# ## @#
#.  $ #
#  #  #
####  #
#######
#######
