#######
##    #
##   .#
###   #
###$ ##
###@  #
#######
