#######
#    ##
#@$  ##
## . ##
##  ###
##    #
#######
