#######
####  #
###   #
###.  #
### $ #
####@ #
#######
