#######
#   @ #
##  $ #
#     #
# .   #
####  #
#######
