#######
# .   #
#     #
#     #
#   $ #
#  @###
#######
