#######
###.  #
### $ #
#  #@ #
## #  #
#     #
#######
