#######
#  ####
#  ####
#    ##
#. $@##
###   #
#######
