#######
#     #
#   . #
### $ #
####@ #
#######
#######
