#######
# . # #
# $   #
# @   #
#######
#######
#######
