#######
#######
### @##
###$  #
##    #
##.   #
#######
