#######
#### @#
#### $#
####  #
#### .#
####  #
#######
