#######
#    ##
#@$. ##
#  ####
#  ####
# #####
#######
