#######
##    #
#   $ #
#.@   #
#  #  #
#######
#######
