#######
#######
#######
#.   ##
#  $ ##
#    @#
#######
