#######
##### #
##### #
## $. #
##   @#
##    #
#######
