#######
#######
#######
#     #
#    @#
#  $ .#
#######
