#######
#    ##
# . ###
# $ ###
# @####
#  ####
#######
