#######
#  .$@#
#     #
#  #  #
#   # #
##    #
#######
