#######
#     #
# $.  #
###   #
####@ #
#######
#######
