#######
#######
### @ #
###  $#
####  #
#### .#
#######
