#######
# #  ##
#    ##
#.    #
#   $ #
#   @ #
#######
