#######
###   #
###   #
#  #@ #
## #$ #
#   . #
#######
