#######
#   ###
# $@###
#   ###
#.  ###
#  ####
#######
