#######
#  .###
# $####
#  @###
# #####
#######
#######
