#######
#  @ ##
#   ###
#.    #
#   $ #
##  ###
#######
