#######
#######
###.@##
###   #
##  $ #
##    #
#######
