#######
#   ###
#  ####
#  .###
# $ ###
# @####
#######
