#######
#    ##
#    ##
#.  $@#
#### ##
#######
#######
