#######
#.#####
# #####
#$#####
#   ###
#  @###
#######
