#######
#    @#
#   $ #
#  #  #
#.  # #
##    #
#######
