#######
##   ##
##    #
##@$ ##
##   .#
#     #
#######
