#######
##@.  #
##    #
#     #
# $ # #
#     #
#######
