#######
###   #
###   #
###@$ #
#     #
# #  .#
#######
