#######
#   @.#
##    #
###$  #
##    #
##    #
#######
