#######
#    .#
#     #
####  #
#####$#
#### @#
#######
