#######
###   #
####  #
#### .#
#### $#
#####@#
#######
