#######
# .@ ##
# $ ###
##  ###
##  ###
#######
#######
