#######
#    ##
# $  ##
##   ##
##   ##
# @.###
#######
