#######
#    ##
#    ##
## . ##
##$  ##
# @ ###
#######
