#######
##@####
## ####
#     #
#. $  #
#     #
#######
