#######
###   #
##@$  #
###   #
####. #
#######
#######
