#######
###   #
### . #
###   #
### $ #
####@##
#######
