#######
#  @###
# $  .#
##    #
#######
#######
#######
