#######
###   #
### $ #
####  #
####  #
####@.#
#######
