#######
#  @ ##
#  $###
#     #
#    .#
##  ###
#######
