#######
#######
#######
# @##.#
#  $  #
#     #
#######
