#######
#  @###
#  $###
##   ##
## .###
#   ###
#######
