#######
# ## @#
#    $#
#  # .#
####  #
#######
#######
