#######
### @.#
###   #
###  $#
###   #
#######
#######
