#######
#  @  #
#   $.#
##    #
#######
#######
#######
