#######
# @   #
# $   #
#  ####
#  ####
#   .##
#######
