#######
####@ #
####$ #
####  #
####. #
##### #
#######
