#######
####  #
####  #
####. #
####$ #
####@ #
#######
