#######
##    #
#     #
# @$. #
#  #  #
#######
#######
