#######
####  #
####  #
# .#  #
#  $  #
#   @ #
#######
