#######
##   ##
##   .#
##@  ##
## $  #
#     #
#######
