#######
#######
#######
#     #
#   $@#
# .   #
#######
