#######
### @ #
### $ #
###.  #
###   #
#######
#######
