#######
#  #  #
#  $  #
#     #
#  @. #
#######
#######
